1111111111111
10010000C0001
1000011110011
1P0011E000001
1111111111111
